uw	Update Window
swdm	Set Window Display Mode
pdd	Process Detail Display
zoom	Zoom
cve	Create Visible Edges
cct	Create Color Table
fv	Fit View
crw	Create Window
wa	Window Area
sctp	Set Color Table Parameters
si	Save Image
mvp	Modify View Parameters 	
sdp	Set Display Parameters
pml	Place/Modify Light
cds	Change Detail Display
csa	Copy Shading Attributes
sasa	Set Active Shading Attributes
wc	Window Center
sws	Set Window Shape
cw	Copy Window
dr	Display Region
cspf	Create Shaded Plot File	
sw	Swap Windows
rw	Rename Window
rvada	Rotate View about Defined Axis
rvb	Rotate View by 3 Points
dy	Dynamics
tdia	Toggle Dynamics in All/Current
seazd	Set Active Z Depth
sedd	Set Display Depths
sevv	Set View Volume
mvv	Modify View Volume
wo	Window On; Window Off
dls	Define Line Style
cas	Cascade
max	Maximize; Restore
tile	Tile
cpptp	Convert Parallel/Perspective Projection to Perspective/Parallel
